hallo I am a testfile
NO for north texture yay
NO for north texture yay
whatever we wanna test,
SO for south texture
EA
WE
this one we can use and edit all we want

now the map is following:
1111
1001
10N1
1111

