NO textures/wolfenstein/grey_stone.xpm

   WE    textures/wolfenstein/red_brick.xpm
 SO textures/wolfenstein/purple_stone.xpm


EA textures/wolfenstein/wood.xpm

    F     18,53,25
C         153,204,255

111111
1N0001
100001
101101
11  11
