WE textures/wolfenstein/grey_stone.xpm

   NO    textures/wolfenstein/red_brick.xpm
 EA textures/wolfenstein/purple_stone.xpm


SO textures/wolfenstein/wood.xpm

    F     18,53,25
C         153,204,255

  1111111
 11100001
10000011
100S001
1001001
111 111
