NO textures/wolfenstein/grey_stone.xpm

   WE    textures/wolfenstein/red_brick.xpm
 SO textures/wolfenstein/purple_stone.xpm


EA textures/wolfenstein/wood.xpm

    F     18,53,25
C         153,204,255
10000000000
111
1N11
11111
1111110
11
01100011
