NO textures/wolfenstein/grey_stone.xpm
SO textures/wolfenstein/purple_stone.xpm
WE textures/wolfenstein/red_brick.xpm
EA textures/wolfenstein/wood.xpm

C 225,30,0
F 225,30,0
F 225,30,0

        1111111111111111111111111
        1N00000000110000000000001
        1011000001110000000000001
        1001000000000000000000001
111111111011000001110000000000001
100000000011000001111111111111111
111101111111110111000000100011
11110111111111011101010010001
11000000110101011100000000001
10000000000000001100000010001
10000000000000000001010010001
110000011101010111010111100111
11110111 1110101 101111000001
11111111 1111111 111111111111
