   11111
   110N0111111
    1100010001
     111111111
